


F 246,      254,    1           5              
SO textures/caca.xpm
WE textures/caca.xpm
NO textures/caca.xpm                  
EA textures/caca.xpm


C 249,78,31


        111111111111111111111111
    111111111E00000000000001
111100000000000000000001111
100000000000000000000001
100000000000000000000001
100000000000000000000001
100000000000000000000001
100000111110000101010001
100000100010000000000001
100000100010000100010001
100000100010000000000001
100000111100001010100001
100000000000000000000001
100000000000000000000001
100000000000000000000001           
100000000000000000000001      
100000000000000000000001              
100000000000000000000001
100000000000000000000001          111
11111111100000000000001           1 01
100100001000000000000001           11
100000101000000000000001
100100001000000000000001
100111111000000000000001
100000000000000000000001
100000000000000000000001
11111111111111111111111
        1111111     111        1
            111111111111








                    111
                    101
                    111