SO /nfs/homes/lauger/Documents/PROJECT/five_circle/vox2_cube3d/textures/wall_2.xpm
WE /nfs/homes/lauger/Documents/PROJECT/five_circle/vox2_cube3d/textures/wall_3.xpm
C 115,15,0
NO /nfs/homes/lauger/Documents/PROJECT/five_circle/vox2_cube3d/textures/wall_1.xpm

F 255,255,255

EA /nfs/homes/lauger/Documents/PROJECT/five_circle/vox2_cube3d/textures/wall_4.xpm
111111111 
100000001
100000001
100000001
100000001
10000N001
111000001
100000001
100000001
111111111